....###..#############...
...##P####.......#...#...
...#.BB...BB..B.B.SSS#...
...#..BBB#....B..#SSS#...
...#.B...#.BB.BB.#SSS#...
...###...#..B....#SSS#...
...#.....#.B.B.B.#SSS#...
...#....######.###SSS#...
...##.#..#..B.B..#SSS#...
...#..##.#.BB.B.B##SS#...
...#.SS#.#..B......#S#...
...#.SS#.#.BBB.BBB.#S#...
...#####.#.......#.#S#...
.......#.#########.#S#...
.......#...........#S#...
.......###############...
.........................