.........................
..............#######....
..............#..SSS#....
..........#####..SSS#....
..........#......S.S#....
..........#..##..SSS#....
..........##.##..SSS#....
.........###.########....
.........#.BBB.##........
.....#####..B.B.#####....
....##...#B.B...#...#....
....#P.B..B....B..B.#....
....######.BB.B.#####....
.........#......#........
.........########........
.........................
.........................