.........................
.........................
.............#####.......
.......#######...##......
......##.#.P##.BB.#......
......#....B......#......
......#..B..###...#......
......###.#####B###......
......#.B..###.SS#.......
......#.B.B.B.SSS#.......
......#....###SSS#.......
......#.BB.#.#SSS#.......
......#..###.#####.......
......####...............
.........................
.........................
.........................