.........................
.........................
.........................
......############.......
......#SS..#.....###.....
......#SS..#.B..B..#.....
......#SS..#B####..#.....
......#SS....P.##..#.....
......#SS..#.#..B.##.....
......######.##B.B.#.....
........#.B..B.B.B.#.....
........#....#.....#.....
........############.....
.........................
.........................
.........................
.........................